00000000000000000000000000000000
00000000000000000000000000000000
00000000000000000000000000000000
00000000000000000000000000000000
00000000000000000000000000000000
00000000000000000000000000000000
22200000000000000000000000000000
00020000000000000000000222222000
00012222222200000000000000000000
00000000000000000000000000000000
22000000000022222222222000000000
11220000000000000000000000000000
11112220000000000000000000000022
11111112000000000000000000002211
11111111000000000000000000000000
11111111222222222222222200000000
00000000000000000000000000000000
00000000000000000000000000000000
00000000000000000000000000000000
00000000000000000000000000000000
00000000000000000000000000000000
00000000000000000000000000000000
00000000000000000000000000000000
00000000000000000000000000000000
22222222222222222222222222222222