00000000000000000000000000000000
00000000000000000000000000000000
00000000000000000000000000000000
22200000000000000000000000000000
00000000000000000000000000000000
00000000000000000000000000000000
00000000000000000000000000000000
00000000000000000000000002222222
00000000000000002222222221111111
00000000000000000000000111111111
00000000000000000000000001111111
00000000000000000000000000001111
00002222222220000000000000000000
00000000000000000000000000000000
00000000000000000000000222222000
00000000000000000000000000000000
00000000000000000000000222222222
22000000022222222222222000000000
11222222000000000000000000000000
11111111000000000000000000000022
11111111000000000000000000002211
11111111000000000000000002221111
11111111222222222222222221111111
11111111111111111111111111111111
11111111111111111111111111111111
11111111111111111111111111111111
11111111111111111111111111111111
11111111111111111111111111111111
11111111111111111111111111111111
11111111111111111111111111111111
11111111111111111111111111111111
11111111111111111111111111111111